####################################################################################################################################
#o          # #     #     # #             #       # #       #     #                                             #       # #     # ##
# # # ####### # ##### ##### # ############# ##### # # ####### ####### ######### # ### # ##### ### ### ########### ### ### # ##### ##
# # #         # # #   #       # #   # #         #                             # #   # # #   #   #   #             # #   #       # ##
# # # ######### # # ### ####### # ### # ####### # ### # # ### # # ##### ######### # # ### ##### # ### ############# ####### ##### ##
# # #                         #               # #   # # #   # # #     #         # # #         # #   #     # #         #           ##
# ### ######### ##### # # ##### ########### ### # ### ### # # # # # # ################### ####### ######### # ######### ### # # ####
#   #         #     # # #                 # # # #   #   # # # # # # #           #   #   #     # #   #     #   #     #     # # #   ##
# ### # ##### # ##### # # # ########### ### # ### # # ##### ##### ####### ##### # ### ######### ##### ##### ### ##### ### # ########
# #   #     # #     # # # #           #   #     # # #   # # # # #       #     #               #                 #       # # # # # ##
##### ### ##### # # # # ### # ### # ####### ############# ### # # # ######### ######### ####### ########### ##### ### ### ### # # ##
#       #     # # # # #   # #   # #       # #   #     #         # #         #         #                   #         #   # # #     ##
##### # # # ####### # # # # # # # ######### # ### ##### ####### ### ### ### ####### ######### ##### ##### ################# # ### ##
#     # # #       # # # # # # # #         #     #   #         #   #   #   #       #   # #   # #   #     # #                     # ##
# # # # # # # ##### ### ### ##### # # # ######### ### ### ### ####### ### # ######### # # ##### ########### ######### # # # # ######
# # # # # # #     #   #   #     # # # #           #     #   #       #   # #       # # # #   #     # #               # # # # #     ##
# ### # # # ### ########### ### # # # # ########### ### # ############# ########### ### # ### ##### # ####### # ##### ### # ########
#   # # # #   #           #   # # # # #   # #   #     # #       #     #         # # #   # # # #             # #     #   # #       ##
# # # # # # # ##### # # # # ##### # ### ### # ### ### ### # ##### ############### # # ### # # # ### ### ##### ############# ########
# # # # # # #     # # # # #     # # #               #   # #     #     #     # #         #         #   #     #             #       ##
# # # ##### # ##### # # ### # ### ### # # ### # ##### ### # ##### ##### ##### # ######### ### # ######### # ### # # # ##############
# # #     # #     # # #   # #   # # # # #   # #     #   # # # #                     #       # #         # #   # # # #             ##
### # # ### # # # ### # # # # # # # ### ### # ### ### ####### # ### ####### ##### ### ####### ##### ####### ### # ############# # ##
#   # #   # # # #   # # # # # # #   #     # #   #   # # #         #       #     #           #     #       #   # #             # # ##
### # # # # ### # ##### # # # # ### # # ### ### # # ### # ######### # ########### # # ### # ### # ### # ##### # # ##### ### # # ####
#   # # # #   # #     # # # # #   # # #   #   # # #               # #         #   # #   # #   # #   # #     # # #     #   # # #   ##
##### # ### # # ### ##### # # # ### # # # # ##### # ### # # ### ### # # ##### ### # # # ### # ##### ### ### # ### ##### ##### ######
#     #   # # #   #     # # # #   # # # # #     # #   # # #   #   # # #     #   # # # #   # #     #   #   # #   #     #     #   # ##
# # # # # # ### ######### # # # # ##### # # ####### # ##### ### ### # # ### ##### ### # ##### # # # # # ### # ### # # # # ### ### ##
# # # # # #   #         # # # # #   #   # #       # #     #   #   # # #   #     #   # #     # # # # # #   # #   # # # # # # # # # ##
##### # # # ### ### ####### ##### ####### # ##### ### # ####### # ##### # ##### ### # # ### ##### # # # # ####### ######### ### # ##
#     # # #   #   #       #     # #       #     # #   #       # #     # #     #   # # #   #     # # # # #       #   #             ##
### # # ### # ####### ### ####### # # # # # # # ##### # # # ### ##### # ### ### ### # # ### ########### # # ### ##### ##############
#   # #   # #       #   #       # # # # # # # #     # # # #   #     # #   # # #   # # #   #           # # #   #                   ##
# ### ### # # ##### # # # # # # # ### # # # # ######### # # # # ### ### # # # ##### ### ####### ### # # ######### ##### # # # ######
# #     # # #     # # # # # # # # #   # # # #         # # # # #   # # # # #       #   #       #   # # # #       #     # # # #     ##
# ### # ### ### # # ### # ### # # ### # ### ### ##### # # # # ####### ############### # ############# ### ### # ### ### ### # # # ##
# #   #   #   # # #   # #   # # # #   # #     #     # # # # #             #         # #         #   # #     # #   #   #   # # # # ##
# ### # ##### # ####### # ##### ### # # ### ### # ##### # # # # ########### ### ######### # # # # ##### ############# # ### # # # ##
# #   #     # #       # #   # #   # # # #     # #     # # # # #         #     #         # # # #   # #       #       # #   # # # # ##
# # ### # ##### ### ### # ### # # ### # # # # # ### # # ### # # # ##### # ############### # ####### ### ### # ################# # ##
# # #   #     #   #   # #     # #   # # # # # #   # # #   # # # #     #                 # #               #                   # # ##
# ##### # ##### # # # # # ####### # # ### # # # # # ####### ##### # # ########### ####### # # # ############# ########### # ### ####
# #     #     # # # # # #       # # #   # # # # # #       #     # # #           #       # # # #             #           # #   #   ##
# # # # # # # # # ### ### # # ### ##### # ### # ### ### # ### # # # # ### # ##### # ##### # # ### ### ### ######### ####### # ######
# # # # # # # # #   #   # # #   #     # # #   #   #   # #   # # # # #   # #     # #     # # #   #   #   #         #       # #   # ##
####### # ##### ##### # # ### ### # # ### # # ### # ### ### # ##### ### # # # # # # # ### # # # # # # ### ##### ############# ### ##
#       #     #     # # #   # #   # #   # # #   # #   #   # #     #   # # # # # # # #   # # # # # # #   #     #             #     ##
# # ### # # # ####### # ### ##### ### ####### # # # # # # # # ##### ### # ### # # # # ### ### # ### # # # # # # ### ################
# # #   # # #       # #   #     #   #   #     # # # # # # # #     #   # #   # # # # #   #   # #   # # # # # # #   #   #           ##
# # # # ### # ##### # # ##### # ### # ### # # # ### # ##### # ##### ### ### # # # ########### # ########### # ##### # # ############
# # # #   # #     # # #     # #   # #   # # # #   # #     # #     #   #   # # # #           # #           # #     # #             ##
### ### # ### # # # ##### ##### ##### # ### # # # # # # # ######### ####### # ##### # ### ##### # # ### ############### # # # # ####
#   #   #   # # # #     #     #     # # #   # # # # # # #         #       # #     # #   # #   # # #   #               # # # # #   ##
####### # # # # ##### ######### # ##### # # # ### ### # # # ####### # # ####### # # ##### # ### # # # ##### # ### # ### # # ### ####
#       # # # #     #         # #     # # # #   #   # # # #       # # #       # # #     #     # # # #     # #   # # #   # #   #   ##
### # # # # # # ### # ##### # # ########### ##### ### # # # # # # # # # ##### # ### ### # # ##### # # # # # ### ####### ### # ### ##
#   # # # # # #   # #     # # #           #     #   # # # # # # # # # #     # #   #   # # #     # # # # # #   #       #   # #   # ##
# # # # # ### # # # # ######### # ##### ##### # ####### ####### # ### # # # ### ##### ####### # ##### # # # ### # # ### ### ### ####
# # # # # #   # # # #       #   #     #     # #       #       # #   # # # #   #     #       # #     # # # #   # # #   # # #   #   ##
# # # # # # # ### # # # # # # # # # ##### # # # ####### ### # # ### # # # # ### ##### ### ######### # # # # # # # ### ### ### # # ##
# # # # # # #   # # # # # # # # # #     # # # #     #     # # #   # # # # #   #     #   #         # # # # # # # #   #       # # # ##
# # # # # # # # ### # ### ### # # # # ### # # # # ### # # # ##### ### # # # # # # # # # # # ### ### ##### ##### # # ####### # # # ##
# # # # # # # #   # #   #   # # # # #   # # # # #   # # # #     #   # # # # # # # # # # # #   #   #   # #   #   # #       # # # # ##
# # # # # ### ##### # # # # # ### # # # ##### # # # ##### ##### # ### ### # ### # # # # # ####### # # # # # ### # # ### # # ### # ##
# # # # # #       # # # # # # #   # # #     # # # #   # #     # #   #   # #   # # # # # #       # # #   # #   # # #   # # #   # # ##
# # # # # # # # # ### ### # ### # # # # ##### # # # # # # ### ##### ### # # ### ### # # # # ####### ####### ### # ### ### ### # ####
# # # # # # # # #   # #   #   # # # # #     # # # # #   #   #     #   # # #   #   # # # # #     # #       #   # #   #   #   # #   ##
# # # ### # # # # ### ### # # ### # # ##### # # ##### # # ### ### ### # # # ### # ### # # # ##### ########### ### # # # ### ### # ##
# # #   # # # # #   #   # # # #   # #     # # #   #   # #   #   #   # # # #   # #   # # # #                 # # # # # #   #   # # ##
# # # # ### # ### ### # ### ### # # ### ####### # # # # # # # ##### ### ### ### # ### # ### # # ########### ### # ##### ####### # ##
# # # #   # # #     # #   #   # # #   #       # # # # # # # #     #   #   #   # #   # # #   # #   #   #   # # #       #       # # ##
### # ### # # # # # # # ##### # # # # ### # ##### # # ### ##### ######### # ### ### ### # # # # ### ### ##### # # # ### ####### ####
#   #   # # # # # # # #     # # # # #   # #     # # #   #     #         # #   #   #   # # # # #             #   # #   #       #   ##
# # # ####### ### # ### ####### # ### # ### # ### # # # # # ### ##### # ### ### ### # # # # ### # ### # ##### ### ##### ####### # ##
# # #     #     # #   #       # # #   #   # #   # # # # # #   #     # #   #   #   # # # # #   # #   # #     # #       #     #   # ##
# # # # ##### # ### # # # ### # # # # ##### # ### ### ### # ### # ##### ### # # # # ### # # # # # ### ####### ### # ########### # ##
# # # # #     #   # # # #   # # # # #     # #   #   #   # #   # #     # # # # # # #   # # # # # #   #       # #   #           # # ##
# ### # ### # ### # # # # ##### ##### # # # # # # # # ### # # # ### ##### ##### # # # ### # ### ### ############# # # # # ##########
# #   # #   #   # # # # #     #   #   # # # # # # # #   # # # #   #           # # # #   # # #     #           #   # # # #       # ##
# ### # ### # # # # # # # # ##### # # # # # # ### # # # # # # # # # ### # # ### ### # # ### # # # ##### # # # # # # ##### # ### # ##
# #   #   # # # # # # # # #     # # # # # # #   # # # # # # # # # #   # # #   #   # # #   # # # #     # # # # # # #     # #   #   ##
# # # # ### # # # # # # ##### ##### # # # ####### ##### # # ### ### # # ### ##### # # ##### # # # # ######### # # # ##### # ##### ##
# # # #   # # # # # # #     #     # # # #       #     # # # #     # # #   #     # # #     # # # # #         # # # #     # #     # ##
# ### # # # # # # ### # ##### # ### # ### ### ######### # # ### # ### # # # # ### # # # ### ### # # ### ######### # # # # # # ### ##
# #   # # # # # # #   #   # # #   # # #     #         # # #   # #   # # # # #   # # # # #   #   # #   #     # #   # # # # # #   # ##
# # ### # # # # # # # # # # ##### # # ### # # # # ### ##### # # # ### # ############# ##### ### # # # ### ### # # # ### ### # ######
# # #   # # # # # # # # #       # # #   # # # # #   #   #   # # #   # #             #     # #   # # #   #   # # # #   #   # #     ##
# # ### # # # # # # # ### # ####### # ### # ### # # ### ### # ### # # # # ##### ##### ### ### # # # # ### # # ### # ########### ####
# # #   # # # # # # # #   #       # #   # #   # # #   #   # #   # # # # #     #     #   #   # # # # #   # #     # #   #   # # #   ##
### # # ### # ##### # ### # ### # ### # # # # ##### # # ### # # # ### # # # ### # ### # ### # # ### ### # ### # # # # # ### # ######
#   # # #   # #     # #   #   # #   # # # # #     # # # #   # # #   # # # #   # #   # #   # # #   #   # #   # # # # #             ##
# # # ##### # # ### # # # # # # # ### # ### # # ### # # ### # ### ### ### # # # ######### ### # ### ### # # # # # # # # ####### ####
# # #     # # # #   # # # # # # #   # #   # # #   # # #   # # #     # #   # # #         # #   #   #   # # # # # # # # #       #   ##
# # # ### # ####### # ##### ### ### ##### # ### ##### # ### # # # # # ### # # # ### ######### # # ### ##### # # # ### # ##### ### ##
# # #   # # #       # #       #   #     # #   #     # # #   # # # # #   # # # #   #       #   # #   #     # # # # #   #     #   # ##
### # ### ##### # # # ##### # # # ##### # # # ############# # # # # # # # ##### ##### ####### # # ### # ### ### # # ### ##### # ####
#   #   # # #   # # # #     # # #     # # # #       #     # # # # # # # #     #     #       # # #   # #   #   # # # #       # #   ##
### # ### # # ### # # # # # # # # ######### ##### ### ##### # ### # # # ### # # # ### # ####### ####### # # # # # # ### ### # # # ##
#   #   #   # #   # # # # # # # #         #     #         # #   # # # #   # # # #   # #     #         # # # # # # # #     # # # # ##
# # # # # # # # # # # # ### # # # # # # # # ### # ######### # ### # # # # # # # # ### # # # ### # ##### # ### ####### # # # ### # ##
# # # # # # # # # # # # #   # # # # # # # #   # #         # #   # # # # # # # # #   # # # #   # #     # #   #       # # # #   # # ##
# # # ### ### # ### ####### ### # # ### # # # ### ########### ### # # ### # # # # ##### # ##### # # ####### ### ##### ### # # # ####
# # #   # #   # #     #       # # #   # # # #   #       # # #   # # #   # # # # #     # #   #   # #     # #   #   #   #   # # #   ##
# ### ### ##### ### # # ### ### # # ### ### ##### # ##### # # ### # # ### ### # ### # # # # # # # # # ### ##### ##### # # ### # # ##
# #     #   #   #   # # #     # # #   #   #     # #         #   # # #   #   # #   # # # # # # # # # #         #     # # #   # # # ##
##### ### # ### # # ### # # ####### ####### ### # # ### # ####### ####### ##### ### # # # # ### # # # ### # ########### # # # ### ##
#       # # #   # #   # # #       #       #   # # #   # #       #       #     #   # # # # # #   # # #   # #           # # # # #   ##
### # ### ####### # ### # # # ##### ### ### # # # # ##### ### # ##### ### ##### ### # # # # # # # # # # ### ####### ### # # ### # ##
#   # #     #     # #   # # #     #   #   # # # # #     #   # #     #   #     #   # # # # # # # # # # #   #       #   # # #   # # ##
# # # # # # ### # # # # # # # # ######### # # # ### ######### # # # # ### # ##### # ##### ### # # # # ################### # ##### ##
# # # # # # #   # # # # # # # #         # # # # #           # # # # #   # #     # #     #   # # # # #                   # #   #   ##
### # # # # # ### # # ### # # ### ### # # ### # # # # ### ### # ### # ### # ##### # # # # # # ####### ### # # # ### ### # # # # # ##
#   # # # # # #   # # #   # #   #   # # #   # # # # #   #   # #   # #   # #     # # # # # # # #         # # # #   #   # # # # # # ##
# # ##### ### # # # # ### # ##### ### # ####### # # ####### ### ### # ### # ####### # ##### ### ### # # # # # # # ### # # # ##### ##
# #     #   # # # # # #   #     #   # #     #   # #       # # #   # #   # # #     # #     # #   #   # # # # # # #   # # # #     # ##
# # # # # ### ### # ####### # ##### ####### ### # # ##### # # # ### # # ### # ####### ### ##### # # # ##### ### ####### # # # # # ##
# # # # # #   #   # #       #     #       #   # # #     # #   #   # # #   #         #   #     # # # #     #   #       # # # # # # ##
# ### # # ### # # # ##### # # # ##### ##### ##### # # # # # # # # # # # # # # # ### # # ### ### # ### ##### # # # ### ######### # ##
# #   # #   # # # # #     # # #     #     #   #   # # # # # # # # # # # # # # #   # # #   #   # #   #     # # # #   #       #   # ##
# ### # # # # # # # # ### # # # ######### # # # # # # # # ######### # ### # # # ############### # # # # # # # # # ########### # # ##
# #   # # # # # # # # #   # # #         # # # # # # # # #         # #   # # # #             #   # # # # # # # # #           # # # ##
### # # # ### # # # # # # ### # # ### # ##### # # ### ### ### # ### ### # ### # # # # ####### # # # # ### ##### ### # # # # ### # ##
#   # # # #   # # # # # # #   # #   # #     # # #   #   #   # #   #   # #   # # # # # #     # # # # #   # #       # # # # #   # # ##
### # # ##### # # # # # ### ### ### ######### # # # ### ### ##### # # ### # # # ####### ### ### ### # # ####### ### # ######### # ##
#   # #     # # # # # # #   #     #         # # # #   #   #     # # #   # # # #           #   # #   # #   #       # #         # # ##
### # ### ### ### # ##### # # # ### ######### # # ####### # ####### ### ### ### # # # ### # ### ### # # ##### # ############# ### ##
#   #   # # # #   # #     # # #   #         # # #       # #       #   #   #   # # # #   # #   #   # # #     # #             #   # ##
### # ##### # ### # ########### ####### ######### ########### ### # ### # ####### # ### ### ### ############### ############# # ####
#   #     #     # #   #               #         #           #   # #   # #       # #   #   #   #               #             # #  x##
####################################################################################################################################
####################################################################################################################################
